##################
#................#
#................#
#................#
#................#
#................#
#................#
:................#
:................#
:................#
:................#
##################
##################
##################