..................
..................
..................
..................
..................
..................
..................
..................
..................
......##..........
..................
###........####..#
###........####..#
###........####..#