..................
..................
..................
..................
..................
..................
..................
..................
..................
..................
...P...........G..
##################
##################
##################