..................
..................
..................
..................
..................
.......F..........
.........###......
.........###......
.####....###......
.........#####....
.........#####.G..
##################
##################
##################