..................
..................
..................
..................
..................
..................
..................
..G.........B.....
####....######....
####....######....
####....######....
####....##########
####....##########
####....##########