..................
..................
..................
..................
..................
..................
..................
..................
.....#F....F#.....
..................
.B......##........
###............###
###............###
###............###