..................
..................
..................
...............G..
######.......###..
.............###..
...........B.###..
........########..
.............###..
.............###..
.............###..
##################
##################
##################