..................
..................
..................
..................
..................
..................
..................
..................
...P..............
###########..G....
###############...
##################
##################
##################